seclude=уединен,
interceptio=прихващане,
tradeof=компромис,
forese=предвиждам,
leak=спукан,
blen=смесвам,
tangibl=осезаем,
mean=средства,
clai=претенция,
idl=празен,
refactore=преработени,
complemen=допълнение,
comprehensiv=изчерпателна,
disputabl=спорен,
convolute=заплетен,
abbreviatio=съкращение,
adhere=придържан,
overl=прекалено,
gui=водач,
to infer=да измисля,
inferenc=умозаключение,
reinforcmen=укрепване,
abus=злоупотреба,
irreveren=непочтителен,
chatte=бърборене,
exploi=експлоатация,
vulnerabilit=уязвимост,
serpen=змия,
robus=здрав,
impropabl=невероятно,
collaps=колапс,
tenkeyles=без ключ,
cree=вяра,
dispose=изхвърлени,изхвърлям,
singleto=единичен,
nou=съществително,
excerp=откъс,
elicite=предизвикани,
likelihoo=вероятност,
sealin=запечатване,
unifie=унифицирани,
permi=разрешително,
impedimen=пречка,
conudru=загадка,
impede=възпрепятстван,
lac=липса,
folk=хора,
intentionally=преднамерено,
craftmanship=майсторство,
peculiarity=особеност,
skimming=преглеждам бегло,
evaluate=оценявам,
hangs=виси,
abrupt=рязко,
selfishness=егоизъм,
lodged=настанен,
elderly=възрастен,
stumble=препъване,
omissions=пропуски,
liability=отговорност,
allege=твърдят,
alleged=предполагаем,
quotes=кавички,
lampshade=абажур,
bluntness=тъпота,
mock=подигравам се,
indeed=наистина,
booze=алкохол,
bound to mock=длъжен да се подигравам,
poverty=бедност,
bound=обвързани,
ordeal=изпитание,
lawsuit=съдебен процес,
immature=незрял,
mature=зрял,
soaking=накисване,
pours=излива се,
цъкане=ticking,
tick=отметка,
content=съдържание,
contented=доволен,
pelted=замерян,
diligence=усърдие,старание,
ought=би трябвало,
promiscuity=безразборност,
appeal=обжалване,
scrutiny=проверка,
contentment=задоволство,
discontentment=недоволство,
purse=портмоне,
undergo=подлагам се,
though=все пак,
appealing=привлекателен,
notch=прорез,
gab=бърборене,
through=през,
dedicated=посветен,
tedious=досаден,
churn out=избивам,
churn=избивам,
stint=ограничение,
taught me=ме научи,
taught=преподавани,
humility=смирение,
even though=въпреки че,
tend=склонен,
stutter=заеквам,
slutter=мръсница,
slur=обида,
gorgeous=великолепен,
tension=напрежение,
boredom=скука,
mingle=смесвам се,
admit=признавам,
pitch=стъпка,
scribbling=драскане,
edgewise=настрана,
overwhelmed=претоварени,
accomplishments=постижения,
accomplish=постигне,
assumptions=предположения,
assume=предполагам,
assuming=предполагайки,
refrain=въздържа,
wheal=хрипове,
detach=отделяне,
squeezing=стискам,
volunteer=доброволец,
excessive=прекомерно,
imperfect=несъвършен,
conveying=предаване,
convey=предавам,
stroke=удар,
unbearable=непоносимо,
bearable=поносимо,
solace=утеха,
resentments=негодувания,
relatively=относително,
observed=наблюдаваното,
observe=наблюдавайте,
attitude=поведение,
invaluable=безценен,
finer=по-фини,
frustrations=разочарования,
plent=изобилие,
reserve=резерв,
tremendous=огромен,
hazardous=опасно,
tissue=тъкан,
bits of tissue=парчета тъкан,
esteem=уважение,
substitute=заместител,
rely=разчитам,
imperative=императивен,
partially=частично,
thrown=хвърлени,
internally=вътрешно,
anticipated=очакван,
flow=поток,
trigger=спусък,задействам,
handle=дръжка,
handler=манипулатор,
surround=обграждам,
derived=получени,
originated=произлязъл,
thus=по този начин,
wrap=обвивам,
wrapped exceptions=опаковани изключения,
external=външен,
pipes=тръби,
dispose pattern=модел за изхвърляне,
disposable=разполагаем,
disposal=изхвърляне,
descendant=потомък,
misleading=подвеждащ,
abnormal=ненормален,
snobbishly=снобски,
decencies=приличия,
decenciy=благоприличие,
unequally=неравномерно,
parcelled=парцелиран,
scorn=презрение,
exempt=освободени,
gestures=жестове,
intricate=сложен,
readiness=готовност,
prominent=виден,
descended=слезе,
participated=участвал,
conferred=предоставени,
casually=небрежно,
append=добавям,
denote=означавам,
peaking=връхна точка,
peak=връх,
in handy=по-удобно,
handy=удобен,
peculiar=особен,
aid=помощ,
facilitate=улеснявам,
hence=следователно,
accomplished=изпълнено,
distinction=разграничение,
comparison=сравнение,
confine=ограничаване,
entire=цяла,
entirely=изцяло,
sticking=залепване,
asterics=звездички,
glance=поглед,
rivals=съперници,
source=източник,
stamp=печат,
snippet=фрагмент,
preserve=запазвам,
hyphen=тире,
distinct=различен,
grip=хватка,
gripping=захващане,
gripped=захванати,
negotiate=преговарям,
instead=вместо,
indead=наистина,
libirate=освобождавам,
clue=улика,
glue=лепило,
tangle=заплитане,
entangle=оплитам се,
expose=излагам,
descendent=потомък,
breed=порода,
generic=бщ,
constrain=ограничавам,
prey=плячка,
flee=бягам,
sketch=скица,
state=състояние,
revise=ревизирам,
particular=конкретно,
preceded=предшестван,
exhaustive=изчерпателен,
resides=пребивава,
obey=подчинявам се,
initial=начален,
simultaneously=едновременно,
overlap=припокриване,
scope=обхват,
dog collar=кучешки нашийник,
assertion=твърдение,
preliminary=предварителен,
negligible=незначителен,
composition=състав,
descriptive=описателен,
dest=цел,
alter=промяна,
tie=връзвам,
pairing=сдвояване,
expansion=разширение,
queue=опашка,опашка,
agenda=дневник,
agendas=дневен ред,
genda=програма,
vie=съревновавам се,
vicious=порочен,
concluded=сключен,
sequential=последователен,
vast=огромен,
resemble=приличат,
query=заявка,
contiguous=съседни,
recursive=рекурсивен,
seldom=рядко,
intersection=точка на пресичане,
peek=надниквам,
collision=сблъсък,
shuffle=разбъркване,
cumbersome=тромав,
cumber=краставица,
sober=трезвен,
versatile=универсален,
elden=старейшина,
native=местен,
enumerable=изброим,
stain=петно,
pierce=пробивам,
anckle=глезен,
outskirt=покрайнина,
clarity=яснота,
geek=маниак,
circular=кръгъл,
inevitable=неизбежно,
loosely=хлабаво,
shattering=разтърсващ,
shatter=разбивам,
presume=предполагам,
ternary=троичен,
succinct=лаконичен,
complain=оплакват,
interfere=меся се,
willing=желаещи,
volunteered=доброволец,
enforcer=изпълнител,
stake=залог,
stack=стек,
concern=загриженост,
pattering=потупване,
patter=бърборене,
pattern=модел,
aprehend=арестувам,
drown=давя се,
vertices=върхове,
compression=компресия,
worth=заслужава си,
hovering=витаене,
hover=завъртане,
utilize=използвам,
gadgetry=джаджи,
glimpse=проблясък,
prosper=просперирам,
seize=изземвам,
cupcake=кексче,
tumble=преобръщам се,
blueprint=план,
errand=поръчка,
dismissed=уволнен,
altitude=надморска височина,
eject=извадете,
willingness=желание,
overpower=надделявам,
overhelmed=претоварени,
burnout=изгоря,
thoughtful=замислен,
snoop=подслушвам,
envelope=плик,
reveal=разкрие,
humble=скромен,
mercury=живак,
provision=осигуряване,
compulsory=задължително,
attach=прикачвам,
pathetic=жалко,
objective=обективен,
intencion=намерение,
utmost=максимално,
dawn=зората,
implicit=косвено,
pointy=остър,
ancestor=прародител,
depicted=изобразен,
tuple=кортеж,
sucessor=наследник,
отсечка=segment,
weighted=претеглени,
weights=тежести,
geeker=маниак,
calculus=смятане,
procreation=създаване на потомство,
succesor=наследник,
sting=жило,
volunteers=доброволци,
outreach=популяризиране,
normie=норма,
cluster=куп,
evaluation=оценка,
separate=отделно,
negation=отрицание,
enrow=вграждам,
enroll=записвам се,
scarse=оскъден,
oblige=задължавам,
interoperable=оперативно съвместими,
pipeline=тръбопровод,
indented=отстъп,
regimented=регламентиран,
onward=нататък,
foremost=преди всичко,
grid=решетка,
void empty=празен празен,
truncate=съкращавам,
pawn=залог,
mesh=мрежа,
curriculum=учебна програма,
fluency=плавност,
rid=отървавам се,
entails=води след себе си,
guts=червата,
snail=охлюв,
bearer=приносител,
aftermath=последствия,
spared=пощадени,
literally=буквално,
repository=хранилище,
parole=условно освобождаване,
acknowledge=признавам,
altar=олтар,
bounty дар=награда дар,
succesion=приемственост,
eligibility=допустимост,
lucrative=доходоносен,
prevail=преобладават,
whitelist=бял списък,
persistent=упорит,
fetch=извличам,
repisotory=хранилище,
miscellaneous=разни,
siren=сирена,
elude=изплъзвам се,
gross=бруто,
features=характеристика,
feature=отличителен белег,
endure=издържам,
repel=отблъсквам,
mittens=ръкавици,
preprocessing=предварителна обработка,
devastated=опустошен,
endorse=одобрявам,
stash=скривалище,
ratted out=изтръгнал,
sobbing=ридаене,
innocent=невинен,
booth=будка,
ease=лекота,
underestimate=подценявам,
comparability=съпоставимост,
grasp understand=схващам разбирам,
embold=насърчавам,
stalking=преследване,
torture=мъчение,
adjacent=съседен,
mobster=мафиот,
coward=страхливец,
testment=изпитание,
elbow=лакът,
seizure=припадък,
riot=бунт,
innoccent=невинен,
yield=добив,
desperation=отчаяние,
utility=полезност,
satisfactory=задоволителен,
